000,000,000,000,000,000,000,000,003

001,001,001,001,001,001,001,001,001

001,000,000,000,000,000,000,000,000

001,001,001,001,001,001,001,001,000

000,001,000,000,000,000,000,001,014

000,001,000,000,000,000,000,001,000

001,001,001,001,001,001,001,001,001

001,001,001,001,001,001,001,001,001

001,012,001,012,001,012,001,012,001

001,001,001,001,001,001,001,001,001

006,006,006,006,006,006,006,006,006