005,005,003,000,000,000,003,005,005

001,001,001,000,000,000,001,001,001

001,001,001,000,000,000,001,001,001

001,014,001,000,000,000,001,001,001

001,001,001,001,001,001,001,001,001

000,000,001,001,001,001,001,000,000

000,000,001,012,001,012,001,000,000

000,000,001,001,001,001,001,000,000

000,000,001,011,001,011,001,000,000

000,000,001,001,001,001,001,000,000

000,000,006,006,006,006,006,000,000