000,000,003,003,000,003,003,000,000

000,000,001,001,141,001,001,014,000

000,000,001,001,001,001,001,000,000

000,000,001,001,001,001,001,000,000

000,000,001,001,001,001,001,000,000

000,000,001,001,001,001,001,000,000

000,000,001,001,001,001,001,000,000

000,000,001,001,001,001,001,000,000

000,000,001,001,001,001,001,000,000

000,014,100,001,001,001,001,000,000

000,000,000,006,006,006,006,000,000