000,003,003,003,003,003,003,003,000

003,002,002,002,002,002,002,002,000

002,002,002,002,002,002,002,002,103

002,002,002,002,002,002,002,002,002

011,011,011,002,002,002,011,011,011

120,011,011,012,012,012,011,011,011

000,000,000,002,002,002,002,002,002

101,000,000,002,002,002,002,002,002

002,014,000,002,002,002,002,002,002

102,000,000,002,006,002,006,002,006

000,000,000,006,000,006,000,006,000