000,005,003,000,000,000,003,005,000

000,002,002,000,014,000,002,002,000

000,002,002,000,101,000,002,002,000

000,002,002,002,002,002,002,002,000

000,002,002,002,002,002,002,002,000

000,002,002,002,000,002,002,002,000

000,002,002,002,002,002,002,002,000

000,002,002,002,002,002,002,002,012

000,000,002,002,002,002,002,000,002

252,000,006,006,006,006,006,000,100

000,000,000,000,000,000,000,000,000