003,003,003,003,003,003,003,003,003

001,001,001,001,001,001,001,001,001

000,001,001,001,001,001,001,001,000

014,012,012,001,001,001,012,012,014

000,011,011,001,001,001,011,011,000

000,011,011,001,001,001,011,011,000

000,011,011,001,001,001,011,011,000

014,012,012,001,001,001,012,012,014

000,001,001,001,001,001,001,001,000

001,001,001,001,001,001,001,001,001

006,006,006,006,006,006,006,006,006