003,003,003,005,005,005,005,005,005

002,002,002,002,002,002,002,002,002

002,002,002,002,002,002,002,002,002

002,002,002,002,002,002,002,002,002

018,002,018,002,018,002,018,002,018

011,012,011,012,011,002,002,002,002

006,002,006,006,006,000,000,000,000

000,002,000,000,103,000,000,101,000

014,002,000,000,002,000,000,002,000

000,102,000,000,100,000,000,002,000

000,000,000,000,000,000,000,006,000