000,000,000,000,000,000,000,000,000

000,000,000,141,145,149,000,000,000

014,103,000,002,002,002,000,107,014

002,002,000,006,006,006,000,002,002

002,002,003,003,003,003,003,002,002

002,002,002,002,002,002,002,002,002

002,002,002,002,002,002,002,002,002

002,011,011,002,002,002,011,011,002

000,120,011,002,002,002,011,128,000

000,000,122,002,104,002,126,000,000

000,000,000,000,000,000,000,000,000