003,003,003,003,003,000,000,000,000

001,001,001,001,001,000,000,000,000

001,001,001,001,001,000,000,000,000

001,001,001,001,001,001,001,001,000

001,001,001,001,001,000,014,001,000

006,001,001,001,001,000,000,001,000

000,006,001,001,001,001,001,001,001

000,000,006,001,001,001,001,001,001

000,000,000,000,001,001,001,001,001

000,000,000,000,000,001,001,001,001

000,000,000,000,000,006,006,006,006