000,000,003,003,003,003,003,000,000

000,000,002,002,002,002,002,000,000

000,002,002,002,002,002,002,002,000

002,002,002,002,002,002,002,002,103

002,002,002,002,002,002,002,002,002

002,002,002,104,002,002,002,002,002

002,000,000,000,141,012,011,011,011

002,000,000,000,002,002,002,002,002

002,014,145,000,002,002,002,002,002

100,000,102,000,002,002,002,002,002

000,000,000,000,006,006,006,006,006