003,003,003,000,005,005,005,005,005

002,002,002,000,002,002,002,002,002

002,002,002,000,002,018,002,018,002

002,002,002,000,002,002,002,002,002

012,012,140,000,002,018,002,018,002

002,002,103,000,002,002,002,002,002

002,002,002,000,000,000,002,018,002

002,002,002,000,101,000,002,002,002

002,002,002,000,002,014,002,018,002

002,002,002,000,102,000,002,002,002

006,006,006,000,000,000,000,000,000