000,000,000,000,003,000,000,000,000

103,000,001,001,001,001,001,000,101

001,001,001,001,001,001,001,001,001

001,001,001,012,012,012,001,001,001

001,001,001,001,001,001,001,001,001

000,000,001,001,001,001,001,000,000

014,000,001,001,001,001,001,000,014

001,001,001,012,012,012,001,001,001

001,000,001,001,001,001,001,000,001

100,000,001,001,001,001,001,000,102

000,000,006,006,006,006,006,000,000