003,003,003,003,003,003,003,003,003

002,002,002,002,002,002,002,002,002

002,002,002,002,002,002,002,002,002

002,002,002,002,002,002,002,002,002

002,002,002,002,002,002,002,002,002

011,000,011,000,011,000,011,000,011

002,000,002,000,002,000,002,000,002

012,014,012,002,002,002,002,000,002

002,000,002,002,002,002,002,000,002

002,002,002,002,002,002,002,002,002

000,000,006,006,006,006,006,000,000