003,003,003,005,005,005,003,003,003

002,002,002,002,002,002,002,002,002

002,002,002,002,002,002,002,002,002

002,002,002,002,002,002,002,002,002

011,002,011,002,011,002,011,002,011

002,018,002,018,002,018,002,018,002

002,002,002,002,002,002,002,002,002

000,012,012,000,000,006,006,000,012

000,002,002,000,000,000,000,000,002

000,002,002,000,014,002,002,002,002

000,006,006,000,000,006,000,000,000