000,000,003,000,000,000,003,000,000

000,000,001,001,001,001,001,000,000

014,001,001,001,001,001,001,001,014

001,001,000,000,001,000,000,001,001

001,000,000,001,001,001,000,000,001

001,000,001,001,001,001,001,000,001

001,001,001,001,001,001,001,001,001

000,001,001,001,001,001,001,001,000

000,001,001,001,001,001,001,001,000

000,001,001,001,001,001,001,001,000

000,006,006,006,006,006,006,006,000