000,000,000,000,000,000,000,000,000

105,107,000,000,000,000,000,000,000

002,002,014,000,000,000,000,000,000

002,002,000,000,003,003,003,000,000

002,002,101,103,002,002,002,002,002

002,002,002,002,002,002,002,002,002

002,002,002,002,002,002,002,002,002

002,002,002,002,002,011,011,011,011

002,002,002,002,002,012,012,012,012

002,002,002,002,002,120,122,124,126

006,006,006,006,006,000,000,000,000