005,005,000,000,000,000,003,003,003

002,002,101,105,103,000,002,002,002

002,012,002,012,002,000,002,002,002

002,002,002,002,002,000,002,002,002

011,002,011,002,011,000,002,002,002

002,002,002,002,002,000,002,002,002

002,012,002,012,002,000,100,002,102

002,002,002,002,002,000,000,002,000

011,002,011,002,011,000,000,002,000

002,002,002,002,002,000,014,104,000

006,006,006,006,006,000,000,000,000