005,005,005,003,003,003,005,005,005

001,001,001,001,001,001,001,001,001

001,001,001,001,001,001,001,001,001

001,001,000,001,001,001,000,001,001

001,001,000,001,001,001,000,001,001

001,001,001,001,001,001,001,001,001

001,001,001,001,001,001,001,001,001

001,001,001,001,001,001,001,001,001

001,001,001,001,001,001,001,001,001

000,001,001,001,001,001,001,001,000

000,006,006,006,006,006,006,006,000