003,005,005,000,000,000,000,000,005

001,001,001,000,103,000,000,000,001

001,001,001,000,001,001,001,001,001

001,001,001,000,001,001,001,001,001

001,001,001,000,001,001,001,001,001

001,001,001,000,000,001,001,001,000

001,001,001,000,000,001,001,001,000

001,001,001,101,001,001,001,001,001

001,001,001,001,001,001,001,001,001

100,001,102,001,001,001,001,001,001

000,000,000,006,006,006,006,006,006