005,005,005,005,000,005,000,000,000

001,001,001,001,000,001,001,103,101

001,001,001,001,000,001,001,001,001

001,001,001,001,001,001,001,001,001

001,001,001,001,000,001,001,001,001

003,001,001,003,000,001,001,001,006

001,001,001,001,000,001,001,001,001

001,001,001,001,000,001,001,001,001

001,001,001,001,000,001,001,001,001

102,001,001,100,000,001,001,001,001

000,000,000,000,000,006,006,006,006