000,000,005,000,005,000,005,000,000

003,000,002,000,002,000,002,000,003

002,000,002,101,002,103,002,000,002

002,000,002,002,002,002,002,000,002

002,000,002,002,002,002,002,000,002

002,000,002,002,002,002,002,000,002

002,000,002,002,002,002,002,000,002

002,000,002,002,002,002,002,000,002

002,000,002,002,002,002,002,000,002

100,000,006,002,006,002,006,000,102

000,000,000,006,000,006,000,000,000