000,000,000,000,000,000,000,000,000

000,000,000,000,000,000,000,000,000

000,000,201,201,201,201,201,201,201

000,000,004,002,004,005,006,003,104

000,000,103,005,002,005,103,004,005

000,000,001,001,103,006,001,001,003

000,000,005,003,006,003,103,005,004

000,000,006,103,002,001,003,002,005

000,000,003,004,106,003,004,105,004

000,000,004,002,001,006,001,002,001

000,000,202,202,202,202,202,202,202