003,000,003,000,003,000,003,000,003

001,005,001,005,001,005,001,005,001

001,001,001,001,001,001,001,001,001

001,001,001,001,001,001,001,001,001

001,001,001,001,001,001,001,001,001

001,001,001,001,001,001,001,001,001

001,001,001,001,001,001,001,001,001

001,001,001,001,001,001,001,001,001

001,000,001,001,001,001,001,000,001

001,000,001,000,001,000,001,000,001

006,000,006,000,006,000,006,000,006