000,000,000,000,000,003,005,005,003

101,103,105,107,000,001,001,001,001

001,001,001,001,000,001,001,001,001

001,001,001,001,000,001,001,001,001

001,001,001,001,000,001,001,001,001

001,001,001,001,000,001,001,001,001

001,001,001,001,000,001,001,001,001

001,001,001,001,000,001,001,001,001

001,001,001,001,000,001,001,001,001

001,001,001,001,000,100,102,104,106

006,006,006,006,000,000,000,000,000