005,005,005,000,000,000,000,003,003

001,001,001,001,001,101,000,001,001

001,001,001,001,001,001,000,001,001

001,001,001,001,001,001,000,001,001

001,001,001,001,001,001,000,001,001

001,001,001,001,001,001,000,100,102

001,001,001,001,001,001,000,000,000

000,000,000,001,001,001,001,001,103

000,251,000,001,001,001,001,001,001

000,000,000,001,001,001,001,001,001

000,000,000,006,006,006,006,006,006