000,000,000,005,003,005,000,000,000

000,000,000,001,001,001,000,000,000

000,000,001,001,001,001,001,000,000

000,001,001,001,001,001,001,001,000

001,001,001,001,001,001,001,001,001

001,001,001,001,006,001,001,001,001

001,001,001,006,000,006,001,001,001

001,001,001,001,000,001,001,001,001

001,001,001,001,001,001,001,001,001

001,001,001,001,001,001,001,001,001

006,006,006,006,006,006,006,006,006