000,000,000,003,003,003,000,000,000

000,000,005,001,001,001,005,000,000

000,000,001,001,001,001,001,000,000

003,001,001,001,001,001,001,001,003

001,001,001,001,001,001,001,001,001

001,001,001,001,001,001,001,001,001

001,001,001,001,001,001,001,001,001

000,001,001,001,001,001,001,001,000

000,006,001,001,001,001,001,006,000

000,000,001,001,001,001,001,000,000

000,000,006,006,006,006,006,000,000