005,000,000,000,005,000,000,000,005

001,001,001,001,001,001,001,001,001

001,003,001,003,001,003,001,003,001

001,001,001,001,001,001,001,001,001

001,000,001,000,001,000,001,000,001

001,001,001,001,001,001,001,001,001

001,001,001,001,001,001,001,001,001

001,001,001,001,001,001,001,001,001 
001,001,001,001,001,001,001,001,001

001,006,001,000,001,000,001,006,001

006,000,006,000,006,000,006,000,006