000,000,003,003,005,005,005,003,003

000,000,001,001,001,001,001,001,002

000,000,001,001,001,001,001,001,001

001,001,001,001,104,106,001,100,102

001,000,000,000,000,000,000,000,000

001,001,001,001,101,103,001,105,107

000,000,001,001,001,001,001,001,001

000,000,001,001,001,001,001,001,001

000,000,001,001,001,001,001,001,001

000,000,001,001,001,001,001,001,001

000,000,006,006,006,006,006,006,006