005,000,000,000,000,000,000,000,003

001,000,000,000,000,000,000,000,001

001,000,000,000,000,000,000,000,001

001,000,000,000,000,000,000,000,001

001,000,000,000,000,000,000,000,001

001,001,001,001,001,001,001,001,001

001,001,001,001,001,001,001,001,001

001,001,001,001,001,001,001,001,001

000,001,001,001,001,001,001,001,000

000,000,001,001,001,001,001,000,000

000,000,000,006,006,006,000,000,000