000,000,000,000,000,000,000,000,000

000,000,000,000,000,000,000,000,000

000,000,000,000,201,201,201,201,201

000,000,000,000,005,006,005,002,002

000,000,000,000,004,003,001,003,003

000,000,000,000,001,005,004,006,006

000,000,000,000,001,007,007,005,005

000,000,000,000,005,001,002,006,001

000,000,000,000,001,004,004,003,002

000,000,000,000,004,003,003,004,005

000,000,000,000,202,202,202,202,202