000,005,003,005,003,005,003,005,000

000,001,001,001,001,001,001,001,000

001,001,001,001,001,001,001,001,001

001,001,001,001,001,001,001,001,001

001,001,001,001,001,001,001,001,001

000,001,001,100,102,104,106,001,000

000,001,001,000,000,000,000,001,000

000,001,001,101,103,105,107,001,000

000,001,001,001,001,001,001,001,000

000,001,001,001,001,001,001,001,000

000,006,006,006,006,006,006,006,000