000,000,000,000,003,000,000,000,000

000,001,001,001,001,001,001,001,000

000,001,001,001,001,001,001,001,000

000,001,001,001,001,001,001,001,000

000,001,006,006,006,006,006,001,000

000,001,000,000,000,000,000,001,000

001,001,001,001,001,001,001,001,001

001,001,001,001,001,001,001,001,001

001,001,001,001,001,001,001,001,001

001,001,001,001,001,001,001,001,001

006,006,006,006,006,006,006,006,006