000,000,000,000,000,000,000,000,000

000,000,000,000,000,000,000,000,000

000,000,201,201,201,201,201,201,201

000,000,001,003,004,006,004,006,005

000,000,004,002,005,003,001,003,004

000,000,005,005,006,006,004,006,005

000,000,003,001,004,005,003,002,003

000,000,006,003,003,001,002,001,002

000,000,003,003,005,003,004,002,004

000,000,004,002,004,006,001,002,001

000,000,202,202,202,202,202,202,202