000,005,003,005,005,005,003,005,000

003,001,001,001,001,001,001,001,003

001,001,001,001,001,001,001,001,001

001,001,001,001,001,001,001,001,001

001,001,001,001,001,001,001,001,001

000,001,001,001,001,001,001,000,001

000,001,001,001,001,001,001,000,001

000,001,001,001,001,001,001,000,001

000,006,006,006,006,006,006,000,001

000,001,001,001,001,001,001,001,001

000,006,000,000,000,000,000,000,000