003,005,005,003,005,003,005,005,003

001,001,001,001,001,001,001,001,001

001,001,001,001,001,001,001,001,001

001,000,000,001,001,001,000,000,001

001,001,001,001,001,001,001,001,001

001,001,001,000,000,000,001,001,001

001,001,001,001,001,001,001,001,001

001,001,001,001,001,001,001,001,001

001,001,001,001,001,001,001,001,001

000,001,001,001,001,001,001,001,000

000,006,006,006,006,006,006,006,000