000,003,000,000,000,000,000,000,000

000,002,002,002,002,002,002,002,000

000,005,005,005,005,000,000,002,000

000,002,002,002,002,002,002,002,000

000,002,002,002,002,002,002,002,000

000,002,002,002,002,002,002,002,000

000,002,002,002,002,002,002,002,000

000,002,002,002,002,002,002,002,000

000,002,002,002,002,002,002,002,000

000,002,002,002,002,002,002,002,000

000,006,006,006,006,006,006,006,000