003,003,003,003,003,003,003,003,003

001,001,001,001,001,001,001,001,001

001,001,001,001,001,001,001,001,000

001,001,001,001,001,001,001,000,000

001,001,001,001,001,001,000,000,000

001,001,001,001,001,000,101,103,105

001,001,001,001,000,001,001,001,001

001,001,001,000,001,001,001,001,001

001,001,001,000,001,001,001,001,001

100,102,104,000,001,001,001,001,001

000,000,000,000,006,006,006,006,006