000,000,005,005,003,005,005,000,000

101,000,002,002,011,002,002,000,103

002,000,002,002,002,002,002,000,002

002,000,002,002,002,002,002,000,002

002,000,002,002,002,002,002,000,002

002,000,002,002,002,002,002,000,002

002,000,011,011,011,011,012,000,002

002,000,011,011,011,011,012,000,002

002,000,011,011,011,011,140,000,002

102,000,006,006,006,006,000,000,002

000,000,000,000,000,000,000,000,006