000,003,003,003,003,003,003,003,000

000,001,001,001,001,001,001,001,000

000,001,001,001,001,001,001,001,000

000,001,001,001,001,001,001,001,000

000,001,001,001,001,001,001,001,000

000,141,123,145,001,001,001,001,000

000,011,012,011,001,001,001,001,000

000,001,001,001,001,001,001,001,000

000,001,001,001,001,011,012,011,000

000,001,001,001,001,140,122,144,000

000,006,006,006,000,000,000,000,000