000,000,003,003,000,003,003,000,000

000,000,001,001,000,001,001,000,000

005,005,001,001,005,001,001,005,005

001,001,001,001,001,001,001,001,001

001,001,001,001,001,001,001,001,001

001,001,001,001,001,001,001,001,001

001,001,001,001,001,001,001,001,001

018,018,018,012,012,012,018,018,018

018,018,018,012,012,012,018,018,018

018,018,018,012,012,012,018,018,018

006,006,000,006,006,006,000,006,006