000,005,005,005,003,005,005,005,003

121,002,002,002,011,002,002,002,011

002,002,002,002,002,002,002,002,002

002,002,002,002,002,002,002,002,002

002,002,002,002,002,002,002,002,002

002,002,002,002,002,002,002,002,002

011,006,011,006,011,006,011,006,120

012,000,012,000,012,000,012,000,012

002,000,002,000,002,000,002,000,002

002,002,002,002,002,002,002,002,002

000,000,000,000,006,000,000,000,000