003,000,000,000,005,000,000,000,003

140,000,121,123,001,145,147,000,144

000,001,001,001,001,001,001,001,000

000,001,001,001,001,001,001,001,000

000,001,001,001,001,001,001,001,000

012,001,001,001,001,001,001,001,011

000,001,001,001,001,001,001,001,000

000,001,001,001,001,001,001,001,000

003,000,001,001,001,001,001,000,003

142,000,006,006,006,006,006,000,146

000,000,000,000,000,000,000,000,000