005,005,005,005,003,000,000,000,000

002,002,002,002,011,002,103,101,002

002,002,002,002,011,002,002,002,002

002,002,002,002,011,002,002,002,002

002,002,002,002,011,002,002,002,002

002,002,002,002,002,002,002,002,002

002,002,002,002,000,012,012,012,012

002,002,002,002,000,011,011,011,011

002,002,002,002,000,002,002,002,002

002,102,100,002,000,002,002,002,002

000,000,000,000,000,006,006,006,006