003,005,005,005,003,000,000,000,000

002,002,002,002,002,000,000,000,000

002,002,002,002,002,000,000,000,000

002,002,002,002,002,011,002,002,002

002,002,002,002,002,000,000,000,002

002,002,002,002,002,000,002,002,012

002,002,002,002,002,000,002,000,000

002,002,002,002,002,000,002,002,012

002,002,002,002,002,000,000,000,002

011,011,011,011,011,000,002,002,002

006,000,006,000,006,000,006,000,000