000,000,000,005,005,005,000,000,000

000,000,000,002,002,002,000,000,000

000,000,002,002,002,002,002,000,000

000,000,002,002,002,002,002,000,000

003,003,002,002,002,002,002,003,003

018,018,011,011,011,011,011,018,018

018,002,002,002,002,002,002,002,018

002,002,002,002,002,002,002,002,002

002,002,002,002,002,002,002,002,002

000,002,002,002,002,002,002,002,000

000,006,006,006,006,006,006,006,000