000,000,000,000,000,000,000,000,003

001,001,001,001,001,001,001,001,001

001,011,011,011,011,011,011,011,011

001,001,001,001,001,001,001,001,001

001,001,001,001,001,001,001,001,001

000,001,001,001,001,001,001,001,000

000,000,001,001,001,001,001,000,000

000,000,000,001,001,001,000,000,000

000,000,000,001,001,001,000,000,000

000,000,000,000,012,000,000,000,000

000,000,000,000,006,000,000,000,000