003,003,003,003,003,003,003,003,003

001,001,001,001,001,001,001,001,001

001,011,012,011,012,011,012,011,001

001,001,001,001,001,001,001,001,001

012,011,012,001,001,001,012,011,012

001,001,001,001,001,001,001,001,001

001,001,001,011,012,011,001,001,001

001,001,001,012,011,012,001,001,001

001,001,001,001,001,001,001,001,001

001,001,001,001,001,001,001,001,001

006,006,006,006,006,006,006,006,006