000,003,003,003,003,003,003,003,000

000,001,001,001,001,001,001,001,000

001,001,001,001,001,001,001,001,001

001,001,001,001,001,001,001,001,001

000,001,001,001,001,001,001,001,000

000,000,011,011,001,011,011,000,000

000,000,011,011,001,011,011,000,000

000,000,011,011,001,011,011,000,000

000,000,011,011,001,011,011,000,000

000,000,011,011,001,011,011,000,000

000,000,006,006,006,006,006,000,000