003,003,003,000,005,005,005,005,005

002,002,002,000,002,002,002,002,002

002,002,002,000,002,002,002,002,002

002,002,002,000,002,002,002,002,002

002,002,002,000,011,011,011,011,011

002,002,002,000,011,011,011,011,011

002,002,002,000,002,002,002,002,002

000,002,000,000,002,002,002,002,002

000,002,000,000,002,002,002,002,002

000,002,000,000,002,002,002,002,002

000,006,000,000,000,000,000,000,000