000,000,000,000,003,000,000,000,000

000,141,002,002,011,002,002,143,000

000,002,002,002,002,002,002,002,000

000,000,002,002,002,002,002,000,000

000,000,002,002,000,002,002,000,000

005,005,002,002,000,002,002,005,005

002,002,002,002,002,002,002,002,002

002,002,002,002,002,002,002,002,002

002,002,002,002,002,002,002,002,002

100,002,002,002,002,002,002,002,102

000,000,006,006,006,006,006,000,000