000,000,000,003,005,003,000,000,000

101,011,018,018,002,018,018,011,103

002,011,018,018,002,018,018,011,002

002,011,018,018,002,018,018,011,002

002,011,018,018,002,018,018,011,002

002,011,018,002,002,002,018,011,002

002,011,018,002,002,002,018,011,002

002,011,018,002,002,002,018,011,002

002,011,018,002,002,002,018,011,002

102,011,018,002,002,140,018,011,002

000,000,006,006,006,000,006,000,006