003,003,005,005,005,005,005,003,003

018,018,011,011,001,012,012,012,012

018,018,011,011,001,012,012,012,012

018,018,011,011,001,012,012,012,012

018,018,011,011,001,001,001,001,001

018,018,011,011,001,001,001,001,001

018,018,011,011,001,001,001,001,001

018,018,011,011,001,012,012,012,012

018,018,011,011,001,012,012,012,012

018,018,011,011,001,012,012,012,012

006,006,006,000,000,006,006,006,006