003,000,003,000,003,000,003,000,003

001,000,001,000,001,000,001,000,001

001,000,001,000,001,000,001,000,001

001,000,001,000,001,000,001,000,001

001,001,001,001,001,001,001,001,001

001,001,001,001,001,001,001,001,001

001,001,001,001,001,001,001,001,001

001,001,001,001,001,001,001,001,001

011,001,011,001,011,001,011,001,011

012,001,012,001,012,001,012,001,012

006,000,006,000,006,000,006,000,006