005,005,005,005,005,003,003,000,000

002,002,002,002,002,011,011,000,105

002,002,002,002,002,011,011,000,002

002,002,002,002,002,011,011,000,006

000,000,000,012,012,002,002,012,012

101,103,000,002,002,002,002,002,002

002,002,000,002,002,002,002,002,002

002,002,000,002,002,002,002,002,002

002,002,000,012,140,002,002,012,012

102,104,000,006,000,002,002,006,006

000,000,000,000,000,006,006,000,000