003,000,003,000,000,000,003,000,000

002,002,002,002,103,002,002,002,101

002,002,002,002,002,002,002,002,002

002,002,002,002,002,002,002,002,002

002,100,002,002,002,002,002,002,102

011,011,011,011,011,011,011,011,011

002,002,002,002,002,002,002,002,002

002,012,002,012,002,012,002,012,002

002,002,002,002,002,002,002,002,002

018,018,018,018,018,018,018,018,018

006,000,006,000,006,000,006,000,006