000,000,000,000,005,005,000,005,005

000,000,000,000,001,001,103,001,001

000,017,000,000,001,001,001,001,001

000,002,000,000,001,018,018,018,001

000,002,000,000,001,018,002,018,001

005,100,005,000,001,018,002,018,001

001,101,001,000,001,012,002,012,001

001,001,001,000,001,012,012,012,001

001,001,001,000,001,001,001,001,001

001,001,001,000,001,001,001,102,001

006,006,006,000,000,000,000,000,000