000,000,000,000,000,000,003,003,000

000,101,103,014,001,001,001,001,000

001,001,001,001,001,001,001,001,105

001,001,001,000,000,000,001,001,001

001,001,001,000,016,000,001,001,001

001,001,001,005,104,005,001,001,001

001,001,001,001,001,001,001,001,001

001,001,001,001,001,001,001,001,001

001,001,001,001,001,001,001,001,102

000,001,001,001,001,100,001,001,000

000,006,006,006,006,000,006,006,000