000,000,003,003,003,003,003,000,000

017,000,002,002,002,002,002,000,105

338,143,002,002,002,002,002,000,002

002,012,002,002,002,002,002,000,002

338,012,002,011,002,011,002,000,002

002,012,002,002,002,002,002,000,002

338,012,002,011,002,011,002,000,002

002,012,002,002,002,002,002,000,002

345,014,002,002,002,002,002,000,002

104,000,002,002,002,002,102,000,002

000,000,006,006,006,006,000,000,006