000,005,005,005,000,005,000,000,000

000,002,002,002,121,002,014,018,000

002,002,002,002,011,002,018,018,002

002,002,002,002,011,002,018,018,002

002,002,002,002,011,002,018,018,002

016,002,002,002,011,002,011,012,017

002,002,002,002,011,002,011,012,002

002,002,002,002,011,002,011,012,002

002,002,002,002,011,002,011,012,100

000,002,002,002,011,002,011,012,000

000,006,006,006,006,006,006,000,000