000,005,000,005,000,005,000,000,000

101,002,103,002,105,002,000,107,000

002,002,002,002,002,002,000,002,000

002,002,002,002,002,002,000,002,000

002,002,002,002,002,002,000,002,000

002,002,002,002,002,002,000,002,014

002,002,002,002,002,002,000,002,000

002,002,002,002,002,002,000,002,000

017,006,016,006,017,146,000,002,000

100,000,102,000,104,000,000,002,000

000,000,000,000,000,000,000,006,000