000,000,005,005,005,000,000,000,000

101,103,001,001,001,000,000,000,000

001,001,001,001,001,000,000,000,000

001,001,001,001,001,001,017,000,000

001,001,012,001,001,000,012,000,000

001,001,001,001,001,001,001,001,001

001,001,001,001,001,001,001,001,001

001,011,001,011,001,011,001,011,001

001,001,001,001,001,001,001,001,001

001,001,001,001,001,001,001,100,102

006,006,006,006,006,006,006,000,000