005,000,005,000,000,000,005,000,005

002,101,002,000,103,000,002,105,002

002,002,002,000,002,000,002,002,002

002,002,002,000,002,000,002,002,002

002,002,002,002,000,002,002,002,002

002,002,002,002,002,002,002,002,002

002,002,002,002,002,002,002,002,002

002,002,002,002,002,002,002,002,002

006,017,006,006,016,006,006,017,006

000,100,000,000,102,000,000,104,000

000,000,000,000,000,000,000,000,000