000,000,000,000,005,000,000,000,000

000,103,000,002,002,002,000,101,000

005,002,000,002,002,002,000,002,005

002,002,002,002,002,002,002,002,002

016,000,002,002,002,002,002,000,016

002,000,002,002,002,002,002,000,002

002,000,002,002,002,002,002,000,002

000,000,002,002,002,002,002,000,000

000,000,002,017,002,002,002,000,000

000,000,006,100,006,102,006,000,000

000,000,000,000,000,000,000,000,000