005,005,005,005,005,000,005,005,005

002,002,002,002,002,101,002,002,002

002,011,002,011,002,011,002,002,002

002,002,002,002,002,002,002,002,002

000,017,000,002,002,012,002,012,016

000,002,011,002,002,002,002,002,002

000,002,011,002,002,011,002,011,002

000,002,011,002,002,002,002,002,002

000,002,011,002,002,012,002,012,002

000,100,011,002,002,002,002,002,002

000,000,000,006,006,006,006,000,000