000,000,005,005,005,005,000,000,000

000,000,001,001,001,001,101,000,000

000,000,001,001,001,001,001,000,000

000,000,001,001,001,001,001,000,000

000,000,001,001,001,001,001,000,000

000,000,001,001,017,001,001,000,000

000,000,001,001,001,001,001,000,000

000,000,001,001,001,001,001,000,000

000,000,001,001,001,001,001,000,000

000,000,001,100,001,001,001,000,000

000,000,006,000,006,006,006,000,000