000,000,000,000,000,000,000,000,000

005,000,000,101,014,103,000,000,005

002,002,002,002,002,002,002,002,002

017,012,002,002,002,002,002,012,017

100,000,002,002,002,002,002,000,102

000,000,002,002,002,002,002,000,000

000,017,002,002,002,002,002,017,000

000,002,002,002,002,002,002,002,000

000,002,002,002,002,002,002,002,000

000,002,002,002,002,002,002,002,000

000,006,006,006,006,006,006,006,000