000,005,005,005,005,005,000,000,000

000,002,002,002,002,002,101,000,000

000,002,002,002,002,002,002,000,000

000,011,011,011,011,011,002,000,000

000,002,002,002,002,002,002,000,017

000,002,011,011,011,011,011,000,002

000,002,002,002,002,002,002,000,002

000,002,002,002,002,002,002,000,100

000,002,002,002,002,002,002,000,000

000,012,012,012,012,012,012,000,000

000,006,006,006,006,006,006,000,000