005,000,000,000,005,005,005,000,000

002,000,000,002,002,002,002,002,000

016,000,121,002,002,002,002,002,017

002,000,011,002,002,018,018,002,002

002,000,011,002,002,018,018,002,002

002,000,011,002,002,018,018,002,006

002,014,011,002,002,018,018,002,017

002,000,011,002,002,002,002,002,002

002,000,006,002,002,002,002,002,002

002,000,000,002,002,002,002,002,100

000,000,000,000,006,006,006,006,000