000,000,000,000,000,000,000,000,000

017,345,345,345,345,000,000,345,017

002,000,005,005,005,005,005,000,002

002,000,002,002,002,002,002,000,002

100,014,002,002,002,002,002,000,102

000,103,011,011,011,002,002,101,000

000,000,002,002,002,002,002,000,000

000,000,002,002,002,002,002,000,000

000,000,002,002,002,002,002,000,000

000,000,002,002,002,002,002,000,000

000,000,006,006,006,006,006,000,000