000,005,000,000,000,000,000,000,000

000,002,002,002,002,002,002,002,002

017,000,005,005,005,005,005,101,002

002,000,002,002,002,002,002,014,002

002,000,002,002,002,002,002,000,002

002,000,002,002,002,002,002,000,002

100,017,002,002,002,002,002,000,002

000,002,002,002,002,002,002,000,002

000,002,002,002,002,002,002,000,002

000,002,002,002,002,002,002,000,002

000,006,006,006,006,006,006,000,006