005,005,005,003,005,005,005,000,000

002,002,002,011,002,002,002,000,000

002,002,002,002,002,002,002,000,342

002,002,002,002,002,002,002,000,017

011,011,011,011,011,011,011,000,002

002,002,002,002,012,002,002,143,002

141,006,002,002,012,002,343,012,002

350,000,006,002,012,002,343,012,002

002,014,000,002,002,002,343,012,002

002,013,000,102,002,002,000,012,100

006,006,000,000,006,006,000,000,000