000,000,000,000,005,005,000,005,005

017,000,016,000,002,002,101,002,002

002,000,002,000,002,002,002,002,002

002,000,002,000,002,002,002,002,002

002,000,002,000,002,011,002,011,002

002,000,002,000,002,002,002,002,002

002,002,002,002,002,011,002,011,002

002,002,002,002,002,002,002,002,002

012,002,012,002,012,002,012,002,012

100,002,002,002,002,002,002,002,002

000,000,006,000,006,000,006,000,006