000,000,005,005,000,005,005,000,000

000,018,002,002,101,002,002,018,000

000,018,002,002,002,002,002,018,000

000,018,002,002,002,002,002,018,000

000,011,011,011,012,011,011,011,000

000,011,011,012,253,012,011,011,000

000,018,018,018,012,018,018,018,000

000,002,002,002,017,002,002,002,000

000,002,002,002,100,002,002,002,000

000,002,002,002,000,002,002,002,000

000,006,006,006,000,006,006,006,000