000,000,000,000,000,000,000,000,000

000,017,000,000,016,000,000,017,000

000,002,000,000,002,000,000,002,000

000,002,000,005,002,005,000,002,000

001,001,001,001,001,001,001,001,001

001,001,001,001,001,001,001,001,001

011,011,011,001,001,001,011,011,011

001,001,001,001,001,001,001,001,001

001,014,000,000,000,000,001,001,001

001,001,001,001,001,000,001,001,001

000,000,000,000,006,000,006,006,006