005,000,000,000,000,000,000,000,000

001,001,001,001,000,101,000,000,103

001,001,001,001,014,001,001,001,001

001,001,001,001,000,001,001,001,001

001,001,001,001,017,001,001,001,001

001,001,001,001,001,001,001,001,001

001,001,001,001,001,001,001,001,001

001,001,001,001,001,001,001,001,001

001,001,001,001,000,001,001,001,001

001,100,001,102,000,001,001,001,001

006,000,006,000,000,006,006,006,006