000,003,003,003,003,003,003,003,000

000,002,002,002,002,002,002,002,000

000,002,002,002,002,002,002,002,000

000,002,002,002,002,002,002,002,000

000,000,011,000,011,000,011,011,000

000,014,002,013,002,013,002,002,000

002,002,002,002,002,002,002,002,002

002,002,002,002,002,002,002,002,002

002,002,002,002,002,002,002,002,002

002,002,002,002,002,002,002,002,002

000,000,000,006,006,006,006,006,000