003,003,005,005,005,005,005,003,003

011,011,002,002,002,002,002,011,011

002,002,002,002,002,002,002,002,002

002,002,002,002,002,002,002,002,002

002,002,002,002,002,002,002,002,002

100,102,002,002,002,002,011,011,011

105,107,006,006,121,123,012,012,014

002,002,002,002,002,002,002,002,002

002,002,002,002,002,002,002,002,002

002,002,002,013,002,002,013,104,106

006,006,000,000,006,006,006,000,000