000,003,003,003,003,003,003,003,000

000,001,001,001,001,001,001,001,000

000,001,001,001,001,001,001,001,000

000,001,001,001,001,001,001,001,000

000,011,013,011,001,001,001,001,000

000,013,014,013,001,001,001,001,000

000,013,011,013,001,001,001,001,000

000,013,013,013,001,001,001,001,000

000,011,013,011,001,001,001,001,000

000,001,001,001,001,001,001,001,000

000,006,006,006,006,006,006,006,000