000,000,003,000,000,000,003,000,000

000,001,001,001,001,001,001,001,000

000,001,000,000,001,000,000,001,000

000,001,000,013,001,013,000,001,000

000,001,000,014,001,014,000,001,000

000,001,000,013,001,013,000,001,000

001,001,001,001,001,001,001,001,001

001,001,001,001,001,001,001,001,001

001,001,001,001,001,001,001,001,001

001,001,001,001,001,001,001,001,001

006,006,006,006,006,006,006,006,006