005,005,005,005,005,000,000,003,000

002,002,002,002,002,018,002,011,002

002,002,002,002,002,000,002,002,002

002,002,002,002,002,000,002,002,002

101,103,002,002,002,000,002,002,002

002,002,002,002,002,000,002,102,104

002,002,002,002,002,000,012,000,000

011,002,011,002,125,000,002,014,000

011,002,011,002,011,000,002,013,000

002,002,002,002,002,000,100,000,000

006,006,006,006,006,000,000,000,000