005,005,000,003,003,003,000,005,005

002,002,000,002,002,002,000,002,002

002,002,000,002,002,002,000,002,002

002,002,011,011,011,011,011,002,002

002,002,002,002,002,002,002,002,002

002,002,002,002,002,002,002,002,002

002,002,002,002,002,002,002,002,002

002,002,002,002,002,002,100,002,002

141,006,006,006,006,000,000,000,014

002,002,002,002,002,002,002,002,013

000,000,000,000,000,000,000,006,000