000,000,000,000,003,000,000,000,000

000,000,001,001,001,001,001,000,000

101,001,001,001,001,001,001,001,001

001,001,001,001,001,001,001,001,001

013,001,001,001,001,001,001,001,013

013,001,001,001,001,001,001,001,013

000,001,001,001,001,001,001,001,000

000,006,006,006,006,006,006,001,000

000,000,000,000,000,000,000,100,000

000,000,000,000,000,000,000,014,000

000,000,000,000,000,000,000,000,000