003,000,003,000,003,000,003,000,003

002,002,002,002,002,002,002,002,002

000,002,002,002,011,002,002,002,002

101,000,002,002,002,002,002,002,002

002,000,000,013,002,002,002,002,002

002,000,000,000,002,002,002,011,002

002,000,000,000,002,002,002,002,002

002,000,000,000,012,000,002,002,002

002,014,000,000,012,000,002,002,002

002,000,000,000,140,000,002,002,002

006,000,000,000,000,000,006,006,006