000,003,003,003,003,003,003,003,000

003,001,001,001,001,001,001,001,003

001,001,001,001,001,001,001,001,001

001,013,018,018,018,018,018,013,001

001,011,014,013,000,013,014,011,001

001,011,011,011,011,011,011,011,001

001,001,001,001,001,001,001,001,001

001,001,001,001,001,001,001,001,001

001,001,001,001,001,001,001,001,001

006,001,001,006,006,006,001,001,006

000,006,006,000,000,000,006,006,000