000,000,000,000,005,003,005,003,005

103,014,101,000,002,011,002,011,002

002,000,002,000,002,002,002,002,002

002,000,002,000,002,002,002,002,002

002,000,002,000,002,002,002,002,002

002,000,002,000,002,002,002,002,002

002,000,002,000,002,002,002,002,002

002,000,002,000,002,002,002,002,002

002,000,002,000,018,018,018,018,018

100,000,002,000,142,013,013,013,013

000,000,006,000,000,006,006,006,006