003,005,005,003,000,000,000,000,000

011,002,002,011,000,014,103,105,014

002,002,002,002,000,013,002,002,013

002,002,002,002,000,013,002,002,013

002,002,002,002,000,013,002,002,013

002,002,002,002,000,006,002,002,006

002,002,002,002,000,101,002,002,107

002,002,002,002,000,002,002,002,002

002,002,002,002,000,002,002,002,002

120,122,124,126,000,002,002,002,002

000,000,000,000,000,006,006,006,006