003,003,000,003,000,003,000,003,003

002,002,002,002,002,002,002,002,002

002,002,011,002,002,002,011,002,002

002,011,012,011,002,011,012,011,002

002,002,011,002,002,002,011,002,002

002,002,002,002,002,002,002,002,002

012,006,006,006,002,006,006,002,002

002,000,000,000,002,000,000,011,011

002,014,013,000,012,000,000,002,002

002,002,002,002,002,002,002,002,002

000,000,000,000,000,000,000,000,006