003,000,000,000,000,000,000,000,003

001,001,001,001,001,001,001,001,001

012,012,012,012,012,012,012,001,000

012,011,001,001,001,001,001,001,000

014,011,001,011,011,013,013,012,000

000,011,001,001,001,001,001,001,000

000,011,011,011,001,001,001,001,000

000,011,001,001,001,001,001,001,000

000,011,001,001,001,001,001,001,000

000,011,001,001,001,001,001,001,000

000,006,006,006,006,006,006,006,000