000,000,005,003,005,003,005,003,000

101,000,002,002,002,002,002,002,103

002,000,002,002,002,002,002,002,002

002,000,002,002,002,002,002,002,002

002,000,002,002,002,002,002,002,002

002,000,100,002,002,002,002,002,002

002,013,000,002,006,002,006,002,006

002,000,000,002,000,002,000,002,000

002,000,000,002,014,002,014,002,000

102,000,000,002,002,002,002,002,000

000,000,000,006,006,006,006,006,000