003,003,003,003,003,003,003,003,003

001,001,001,001,001,001,001,001,001

001,013,013,013,013,013,013,013,013

001,001,001,001,001,001,001,001,001

013,013,013,013,013,013,013,013,001

001,001,001,001,001,001,001,001,001

001,001,001,013,013,013,013,013,013

001,001,001,001,001,001,001,001,001

001,001,001,001,001,001,001,001,001

011,011,011,011,011,011,011,014,011

000,000,006,006,006,006,000,000,006