000,000,003,000,000,000,003,000,000

000,002,002,014,141,014,002,002,000

002,002,000,013,002,013,000,002,002

002,000,013,002,002,002,013,000,002

002,000,006,006,006,006,006,000,002

002,002,002,002,002,002,002,002,002

002,002,002,002,002,002,002,002,002

002,002,002,002,002,002,002,002,002

000,002,002,002,002,002,002,002,000

000,006,002,002,100,002,002,006,000

000,000,006,006,000,006,006,000,000