003,000,000,000,000,000,000,000,003

002,012,012,012,101,018,018,018,018

002,014,013,002,002,002,018,018,018

018,013,002,002,002,002,002,018,018

018,002,002,002,002,002,002,002,018

018,006,006,006,006,006,006,006,018

002,005,005,005,005,005,005,005,002

011,002,002,002,002,002,002,002,011

011,002,002,002,002,002,002,002,011

011,002,002,002,120,002,002,002,011

006,006,000,000,000,000,000,006,006