000,000,003,003,003,003,003,000,000

000,000,001,001,001,001,001,000,000

000,011,001,001,001,001,001,012,000

013,011,001,001,001,001,001,012,013

000,011,001,001,018,001,001,012,000

014,011,001,001,012,001,001,012,014

000,011,001,001,018,001,001,012,000

013,011,001,001,001,001,001,012,013

000,011,001,001,001,001,001,012,000

000,006,001,001,001,001,001,006,000

000,000,006,006,006,006,006,000,000