003,000,005,005,005,005,005,000,003

002,014,002,002,002,002,002,000,002

002,000,002,002,002,002,002,000,002

002,000,002,002,002,002,002,000,002

002,000,002,002,002,002,002,000,002

002,000,002,002,002,002,002,000,002

002,000,002,002,002,002,002,000,002

002,000,000,000,000,000,000,000,002

002,000,013,000,000,000,000,000,002

002,002,002,002,002,002,002,002,002

000,000,000,006,000,006,000,000,000